...###
..##.#.##.#
.##..###..#
##........#
....@..#..#
###..###..#
..#..#.....
.##.##.#.##
.#......##
.#.....##
.#####.#