...###.###.#
..##.#...##.
.##..###..#.
##.....#...#
#...@..#..#.
###..#.#..##
.....#....#.
.##.##.##.#.
.#......#.#
.#.....##
.#######