...###.###.#.#.
..##.#...##.#..
.##.@###..#...#
##........##.##
#......#..#..##
###.##.#..#.###
..#..#....#.###
.##.##.##.#.###
.#......#...###
.#..#..########
.##############